----------------------------------------------
----------------------------------------------
----------------------------------------------
----------------------------------------------
----------------------------------------------
----------------------------------------------
------------------********--------------------
---------------**************-----------------
-------o-----******************---------------
**********************************************
**********************************************
