----------------------------------------------
----------------------------------------------
----------------------------------------------
----------------------------------------------
------------------********--------------------
---------------**************-----------------
-------------******************---------------
**********************************************
