++++++++++++++++++++++++++++++++++++++++++++++++++++++++++++++++++
+-----------------------------------------------------------------
+-----------------------------------------------------------------
+-----------------------------------------------------------------
+-----------------------------------------------------------------
+-----------------------------------------------------------------
+-----------------------------------------------------------------
+-----------------------------------------------------------------
+-----------------------------------------------------------------
+-----------------------------------------------------------------
+-----------------------------------------------------------------
+-----------------------------------------------------------------
+-----------------------------------------------------------------
+-----------------------------------------------------------------
+----------$-----------------------------?---###------------------
+---------****-------------$--------------------------------------
+-----$$$$$---------------------!---------------------g-----------
***************~~~~~~~~*************--****************************
************************************--****************************
^^^^^^^^^^^^^^^^^^^^^^^^^^^^^^^^^^^^^^^^^^^^^^^^^^^^^^^^^^^^^^^^^^