----------------------------------------------
----------------------------------------------
----------------------------------------------
----------------------------------------------
----------------------------------------------
----------------------------------------------
----------------------------------------------
----------------------------------------------
----------------------------------------------
----------------------------------------------
--------------b-------------------------------
----------------------------------------------
----------------------------------------------
-----------------------####-------------------
-----------$--------------------?-------------
----------****---###-------$------------------
-------g--------------------------------------
***************~~~~~~~~*************--********
************************************--********
^^^^^^^^^^^^^^^^^^^^^^^^^^^^^^^^^^^^^^^^^^^^^^
