+++++++++++++++++++++++++++++++++++++++++++++++++++++++++++++++++++++++++++++++++++++++++++++++++++++++++++++++++++++++++++++++++++++++++++++++++++++++++++++++++++++++++++++++++++++++++++++++++++++++++++++++++++++++++++++++++++++++++++++++++++++++++++++++++++++++++++++++
+-----------------------------------------------------------------------------------------------------------------------------------------------------------------------------------------------------------------------------------------------------------------------------+
+-----------------------------------------------------------------------------------------------------------------------------------------------------------------------------------------------------------------------------------------------------------------------------+
+-----------------------------------------------------------------------------------------------------------------------------------------------------------------------------------------------------------------------------------------------------------------------------+
+-----------------------------------------------------------------------------------------------------------------------------------------------------------------------------------------------------------------------------------------------------------------------------+
+-------------------------------------------------------------------------------------------------------------------------------------------------------------------------------------------------------------------------------------------------------$----$---$----------$-+
+-----------------------------------------------^^^----------------------------------------------------------------------------------------------------------------------------------------------------------------------------------------------------$*----$---$$--------$$-+
+-----------------------------------------------***------------------------------------------------------------------------------------------------b---------------------------------------^^^^^^^^^^^^^^^^^---^^^^^^^---^^^^^^^^^^^^^^---------------$**----$---$-$------$-$-+
+-------------------------$---------------------***----------------------------------------------------------------------------------------------------------------------------------------*****************---*******---**************--------------$***----$---$--$----$--$-+
+----------------------$-----$------------------***--------------------------------------------------------------------------$---------$-----$-----$--------------------------$----b---b----------------$----b----$----b----$---------------$-------$****----$---$---$--$---$-+
+------------------------------------------$----***-------------------------------------------------------------------------***-------***^^^***---***--------------------b-$-----$--------------------$---$-----$---$-----$---$-----------$---$----$*****----$---$----$$----$-+
+-----------------------------------------$$$----$----------------------------------------------------------------------------------------------$------------g-----b--$--------------b---b--------------g---------g---------g---------------g-----$******----!----------------+
+-----------------------------------------$$$----$--b-----------------------------------$-------------------------------------------------------$------$**********---***-b-**^^^**---------*****---**********^*********^**********-----****************************************
+-------------------$*---------*$----------$----***------------$$$$$-------------------$$$----------------$--------$------------------$$$$$-----$-----$**-----------------------------------------**--------------------------------------------------------------------------+
+------**?**-------$**---------**$--------------***------------**?**--------------------$----------------***------***-----------------**?**-----$----$**---------------------$$$$$---------------**---------------------------------------------------------------------------+
+-----------------$***---------***$-------------***---------------------------------------------------------------------------------------------$---$**----------------------**?**--------------**----------------------------------------------------------------------------+
+----------------$****----g----****$-------g----***--------------g----------------------g-----------$-----------------------------------g-------$--$**-----------------------------------------**-----------------------------------------------------------------------------+
******************************************************************************------*********------***------------------------------*****************-------------$$$$$$$$$$$$$$$$$$$$$$$$$$$$**------------------------------------------------------------------------------+
******************************************************************************------*********------***------------------------------****************--------------*****************************-------------------------------------------------------------------------------+
^^^^^^^^^^^^^^^^^^^^^^^^^^^^^^^^^^^^^^^^^^^^^^^^^^^^^^^^^^^^^^^^^^^^^^^^^^^^^^^^^^^^^^^^^^^^^^^^^^^^^^^^^^^^^^^^^^^^^^^^^^^^^^^^^^^^^^^^^^^^^^^^^^^^^^^^^^^^^^^^^^^^^^^^^^^^^^^^^^^^^^^^^^^^^^^^^^^^^^^^^^^^^^^^^^^^^^^^^^^^^^^^^^^^^^^^^^^^^^^^^^^^^^^^^^^^^^^^^^^^^^^^^^^^^^^