++++++++++++++++++++++++++++++++++++++++++++++++++++++++++++++++++++++++++++++++++++++++++++++++++++++++++++++++++++++++++++++++++++++++++++++++++++++++++++++++++++++++++++++++++++++++++++++++++++++++++++++++++++++++++++++++++++++++++++++++++++++++++++++++++++++++++++++++++++++
+------------------------------------------------------------------------------------------------------------$$$$$$------------------------------------------------------------------------------------------------------------------------------------------------------------------+
+------------------------------------------------------------------------------------------------------------$$$$$$-----------------------------------------------------------------------------------------------------------------------------------------------------$$$$$$$$$$$$$+
+------------------------------------------------------------------------------------------------b-----------$$$$$$------------g--------------$$$------###--------------------------------------------------------------------------------------------------------------$$$$$$$$$$$$$+
+------------------------------------------------------------------------------------------------------------######--------#########------------------------------$$$------------$$$$-----------------------------------------------------------------------------------*************+
+-------------------------------------------------------------------------------$$$$$$-----------------------------------------------------------------------------------------########----------------------------------------------------------------------------##----------------+
+---------------------------------------------------------------------?---------######------------------------------------------------------------b----------------g---------------------------------------------------------------------------------------------------------------?-+
+----------------------------------------------------------------------------------------------------------------------b-------------------##----------------############------------------------------------------------------------------------------------------------------------+
+---------------------------------------------------------------------------------------------######----------------------------------------------------------------------------------------------######--------------------------------------------------##-------------------------+
+--------------------------------------------------------------------###-----------------------------------------------------------------------------------------------b----------------------------------------------------------------------------------------------------------***+
+-----------------------------------------------------------------------------------------------------------------------------------------------------------------------------------------???----------------------------------------------------------------------------##----------+
+-------------------?--------------------------------------------------------######-------------------------$$$$$$$$$-------------------##########--------##---------------------b---------------------------------------------------------------------------------------------------+
+---------------------------------------------------------------g-------------------------------------------#########---------------------------------------------####----$$$$------------------------------------------------------------------------------#####--------------------+
+------------------------------------------------------------#######--------------------------------------------------------------------------------b---------------------------------##########-------------------------------------------------------------------------------------+
+-----------------*****----------------------###-------------------------------------------------------------------------######------------------------------------------------------------------------------------------------------------------******------------------------------+
+---------------------------------------------------------------------------------------------------------------------------------------------------------------------------------------------------------------------------------------------***------------------------------------+
+-----$$$$$-----------------$$$$$---------------------g--------------g------------------------------#######-----------------------------------####------###------####----------------------------------------------------------------------------------------------------------------+
************************************--*****************************************-----************-------------------------------------------------------------------------#####-----####-----######--------------------------------------------------------------$$$-----!-------$$$--+
************************************--*****************************************-----************-------------------------------------------------------------------------------------------------------------------***********************---------------------***********************
^^^^^^^^^^^^^^^^^^^^^^^^^^^^^^^^^^^^^^^^^^^^^^^^^^^^^^^^^^^^^^^^^^^^^^^^^^^^^^^^^^^^^^^^^^^^^^^^^^^^^^^^^^^^^^^^^^^^^^^^^^^^^^^^^^^^^^^^^^^^^^^^^^^^^^^^^^^^^^^^^^^^^^^^^^^^^^^^^^^^^^^^^^^^^^^^^^^^^^^^^^^^^^^^^^^^^^^^^^^^^^^^^^^^^^^^^^^^^^^^^^^^^^^^^^^^^^^^^^^^^^^^^^^^^^^^^^^^^^