+++++++++++++++++++++++++++++++++++++++++++++++++++++++++++++++++++++++++++++++++++++++++++++++++++++++++++++++++++++++++++++++++++++++++++++++++++++++++++++++++++++++++++++++++++++++++++++++++++++++++++++++++++++++++++++++++++++
+---------------------------------------------------------------------------------------*******************-------------------------------------------------------------------------------------------------------------------------+
+---------------------------------------------------------------------------------------*$$$$$----------$-*-------------------------------------------------------------------------------------------------------------------------+
+---------------------------------------------------------------------------------------*$$$$$----------$-*-------------------------------------------------------------------------------------------------------------------------+
+---------------------------------------------------------------------------------------*$$$$$--------*-$-*-------------------------------------------------------------------------------------------------------------------------+
+---------------------------------------------------------------------------------------*******---**--*-$-*-------------------------------------------------------------------------------------------------------------------------+
+---------------------------------------------------------------------------------------*-------------*-$-*-------------------------------------------------------------------------------------------------------------------------+
+---------------------------------------------------------------------------------------*-------------*-$-*-------------------------------------------------------------------------------------------------------------------------+
+---------------------------------------------------------------------------------------*b--$-------$-*-$-*--------------------------$$$--------------------------------------------------?-----------------------------------------+
+---------------------------------------------------------------------------------------*$-****^^^*****-$-*---------------------b----~~~-----b---------------------------$$$$$$-----------------------------------------------------+
+-------------------------------------------------?-------------------------------------*$------------*-$-*-------------------------------------------------------------------------------------------------------------------------+
+---------------------------------------------------------------------------------------*$------------*-$-*--------------------------------------------------------------~~~~~~----b----~~~~~~~-------------------------------------+
+---------------------------------------------------------------------------------------*$----g-------*-$-*-------$$$$---------~~~~~~~~~~~~~~~~-----------------$$$$$$--------------------------------------------------------------+
+-----------------------------------------------$~~~$----------------------------$$-----************-$*-$-*-------------------------------------------------------------------------------------------------------------------------+
+---------------------------------------------$~~~~~~~$-------------------------$--$----*------------$*-$-*------~~~~~~-----------------------------------------~~~~~~-------------------------------~~~~~~~------------------------+
+-------------------------------------------$~~~~~~~~~~~$----------------------$----$----------------$*-$---------------------------------------------------------------------------------------------------------------------------+
+------------$$$-------------g------------$~~~~~~~~~~~~~~~$-----------g-----------------------g------$*-$-----------g-----------------------g--------------------g----------------------------g------------------------------!------+
~~~~~~~~~~~~~~~~~~~~~~~~~~~~~~~~~~~~~~~~~~~~~~~~~~~~~~~~~~~~~~~~~~~~~~~~~~~~~~~-----~~~~~~~~~~~~~~~~~~~~~~~~~~~~~~~~~~~~~~~~~~~~~~~~~---~~~~~~~~~~~~~~---~~~~~~~~~~~~~~~~~~~~~-----------~~~~~~~~~~~~~~~~~~~~~~~~~~~~~~~~~~~~~~~~~~~~
~~~~~~~~~~~~~~~~~~~~~~~~~~~~~~~~~~~~~~~~~~~~~~~~~~~~~~~~~~~~~~~~~~~~~~~~~~~~~~~-----~~~~~~~~~~~~~~~~~~~~~~~~~~~~~~~~~~~~~~~~~~~~~~~~~---~~~~~~~~~~~~~~---~~~~~~~~~~~~~~~~~~~~~-----------~~~~~~~~~~~~~~~~~~~~~~~~~~~~~~~~~~~~~~~~~~~~
^^^^^^^^^^^^^^^^^^^^^^^^^^^^^^^^^^^^^^^^^^^^^^^^^^^^^^^^^^^^^^^^^^^^^^^^^^^^^^^^^^^^^^^^^^^^^^^^^^^^^^^^^^^^^^^^^^^^^^^^^^^^^^^^^^^^^^^^^^^^^^^^^^^^^^^^^^^^^^^^^^^^^^^^^^^^^^^^^^^^^^^^^^^^^^^^^^^^^^^^^^^^^^^^^^^^^^^^^^^^^^^^^^^^^